9 9
372  106  112  69  163  38  66  23  -20  
127  209  66  107  77  82  6  13  12  
155  60  118  45  56  19  25  19  -10  
80  111  4  18  -2  11  2  -14  -1  
112  9  -9  -38  -70  -50  -44  -40  -94  
11  41  -17  -53  -39  -99  -63  -117  -55  
47  -19  -75  -55  -117  -64  -221  -95  -154  
-30  -39  -18  -151  -99  -175  -116  -290  -209  
-55  -28  -91  -91  -229  -78  -167  -185  -589  